+-+-+-+-+-+-+-+-+-+-+-+-+-+-+-+-+-+-+-+-+-+-+-+-+-+
############|   |       |#####|#######|       |   |
+-+-+-+-+-+#+-+ + +-+-+ +#+-+#+#+-+ +#+ +-+-+ + + +
|#####|    #|   | |     |#|###|#| | |#|   |     | |
+#+ +#+-+-+#+ +-+ + +-+-+#+#+-+#+ + +#+-+-+ +-+-+ +
|#| |#|#####|   | | |   |#|#|###|   |#####  |     |
+#+-+#+#+-+-+-+ + + +-+ +#+#+#+-+-+-+-+-+#+-+ +-+-+
|#|###|###|     | |   | |#|#|#|  #########|   |   |
+#+#+-+ +#+-+ + + +-+ + +#+#+#+ +#+-+-+-+-+ +-+-+ +
|#|###| |#|   | | |   | |#|###| |#|   |           |
+#+-+#+-+#+ +-+ +-+ +-+ +#+-+-+ +#+ +-+ +-+ +-+-+-+
|###|#####|   |    #####|#|     |#|     | | |   | |
+-+#+-+-+-+-+ +-+-+#+-+#+#+ +-+-+#+-+-+-+ + + + + +
|  #########| |###|###|###|   |###|###|   |   | | |
+ +-+-+ +-+#+ +#+#+-+#+-+-+-+ +#+-+#+#+ +-+-+ + + +
| | |     |#|###|#|###|       |#|###|#|       |   |
+ + + +-+ +#+#+-+#+#+-+-+-+-+-+#+#+ +#+-+-+-+-+-+-+
| | | |   |#|#| |###    |     |#|#| |#######|     |
+ + + + +-+#+#+ +-+ +-+ + +-+ +#+#+-+-+-+-+#+ +-+ +
|   | |   |###|   | |   |   | |###|     |  #####| |
+-+-+ +-+ +-+-+-+ +-+ +-+-+-+ +-+-+ +-+ + +-+ +#+-+
|   |   | |     |     |     | |   |   | |   | |###|
+ + +-+-+ + +-+ +-+ +-+-+-+ + +-+ +-+-+ +-+ + +-+#+
|         |   |     |   |     |     |   |     |  ##
+-+-+-+-+-+-+-+-+-+-+-+-+-+-+-+-+-+-+-+-+-+-+-+-+-+
